405F 404F 403F 402F 401F   E   E   423F 422F 421F 420F 419F

406TD 407TD 408TD 409FD 410FD 411FD 412FD 413FD 414FD 415FD 416TD 417TD 418TD

    |-------------------------------------|
    |                                     |
    |      POOL                           |
    |                                     |
    |-------------------------------------|