305D 304D 303D 302D 301D   E   E   323D 322D 321D 320D 319D

306T 307T 308T 309F 310F 311F 312F 313F 314F 315F 316T 317T 318T

    |-------------------------------------|
    |                                     |
    |      POOL                           |
    |                                     |
    |-------------------------------------|