505T 504T 503T 502T 501T   E   E   523D 522D 521D 520F 519F

506V 507V 508V 509V 510V 511V 512V 513V 514V 515V 516V 517V 518V

    |-------------------------------------|
    |                                     |
    |      POOL                           |
    |                                     |
    |-------------------------------------|