105S 104S 103S 102S 101S   E   E   123D 122D 121D 120D 119D

106D 107D 108D 109D 100D 110D 120D 130DD 140DD 150T 160T 170T 180T

    |-------------------------------------|
    |                                     |
    |      POOL                           |
    |                                     |
    |-------------------------------------|