205S 204S 203S 202S 201S   E   E   223S 222S 221S 220S 219S

206D 207D 208D 209D 210D 211D 212D 213D 214D 215T 216T 217T 218T

    |-------------------------------------|
    |                                     |
    |      POOL                           |
    |                                     |
    |-------------------------------------|